---------
-0-S-0-0-
---|-----
-s|1|1|e-
---|-----
-0-W-0-0-
---------