x:9
y:7
---------
-0-1-0-0-
---|-----
-s|1|1|1-
---|-----
-0-1-0-0-
---------